{
    "id": 1,
    "colunas": 12,
    "linhas": 9,
    "tamanho_tile": 32,
    "urlImagem": "./spritesheets/images.png",
    "posicao_inicial_jogador": {
        "x": 32,
        "y": 160
    },
    "tem_inimigos": false,
    "posicao_inicial_inimigo": {
        "x":null,
        "y":null
    },
    "mapa_grafico":[
        [1,1,1,1,1,1,1,1,1,1,1,1],
        [1,1,1,1,1,1,1,1,1,1,1,1],
        [1,1,1,1,1,1,1,1,1,1,1,1],
        [1,1,1,1,1,1,1,1,1,1,1,1],
        [1,1,1,1,1,1,1,1,1,1,1,1],
        [1,1,1,1,1,1,1,1,1,1,1,1],
        [2,2,2,2,2,2,2,1,1,2,2,2],
        [2,2,2,2,2,2,2,1,1,2,2,2],
        [2,2,2,2,2,2,2,1,1,2,2,2]
    ],
    "mapa_colisao": [
        [0,0,0,0,0,0,0,0,0,0,0,0],
        [0,0,0,0,0,0,0,0,0,0,0,0],
        [0,0,0,0,0,0,0,0,0,0,0,0],
        [0,0,0,0,0,0,0,0,0,0,0,0],
        [0,0,0,0,0,0,0,0,0,0,0,0],
        [0,0,0,0,0,0,0,0,0,0,0,0],
        [1,1,1,1,1,1,1,1,1,1,1,1],
        [1,1,1,1,1,1,1,1,1,1,1,1],
        [1,1,1,1,1,1,1,1,1,1,1,1]
    ]
}